111111111111111111111111
111100000000000000001111
111100000000000000001111
111100000000000000001111
1P0100000000000000001111
100100000000000000001111
100100000000000000001111
100100000022200000001111
100006070627260706070001
100000000022200000000001
111100000000000000001001
111100000000000000001001
111100000000000000001001
111100000000000000001001
111100000000000000001331
111100000000000000001331
111111111111111111111111
111111111111111111111111