111111111111111111111111
1P0122100000001221200001
100100500001001000100001
100100011121005000001001
100100126400001100111001
100100100000001000001001
100100100000001000001001
100100110011111204001001
100100120021221000001001
100100120021004700001001
100100100001001000001001
100100100700000000111001
100600004000001000111001
100011000000001000001001
100002110000000500000001
100011222113331100005001
100011111111111111111101
100000000000000000002221
111111111111111111111111