111111111111111111111111
110000012100000000000221
100000012270000010000111
121010001100000010005001
120057100000000011007001
121011111100000010000001
111000001211000014000001
100100521220110010011221
100113111220011110P00111
100111221110040001100001
100001221220000000011001
100000051217105000000101
100000000111060010000001
100010000001000120000001
170011000000001227000001
140000110111111111111101
110002227000000005022201
111111111111111111111111