111111111111111111111111
1P0100000000000005002221
100100000000000004002221
100000000000000005000671
100000000000600000000001
100000000000000000000001
100000001100000000000001
100000000000000000700001
100000700000000000000001
100000000011111000000001
100000000000221000000001
100000000000221000000001
100500000000000000000001
100000000004000600100111
111100000000050022100331
111204000000000022100331
111111111111111111111111
111111111111111111111111